A C?: AH! SI?
AAF: As A Friend
ADAD: Another Day Another Dollar
ADIH: Another Day In Hell
ADIP: Another Day in Paradise
AEAP: As Early As Possible
AFAICR: As far as I can remember
AFAICS: As far as I can see
AFAICT: As far as I can tell
AFAIK: As far as I know
AFAIR: As far as I remember
AFAP: As Far As Possible
AFK: Away from keyboard
ALOL: Actually laughing out loud
ASAP: As soon as possible
ASL: Age / sex / location
A/S/L: Age / sex / location
ASLP: Age, sex, location, picture
A/S/L/P: Age, sex, location, picture
ATEOTD: At The End of the Day
ATB: All the best
ATM: At the moment
AWOL: Absent Without Official Leave
AYBABTU: all your base are belong to us

B2B: Business to Business
B2C: Business to Customer
B4: Before
BBIAB: Be back in a bit
BBQ: Barbecue
BBL/BBS: Be back later / shortly / soon
BCNU: Be seein you
BFF: Best Friends Forever
BFN: Bye For Now
BOFH: Bastard operator from hell
BRB: Be right back
BSOD: Blue Screen of Death
BTDT: Been there done that
BTW: By the way
bump: Bring Up My Post

CMIIW: Correct me if I am wrong
CU: See you later
CYA: See ya

DFTT: Do not feed the trolls
DFTBA: Do not forget to be awesome
DGAF: Do not give a fuck
DIAF: Die in a fire
D/L: Download
DND: Do not disturb
DOA: Dead on arrival

EOF: End of File
EOM: End of Message
EOL: End of Life
EQ: EverQuest
ETA: Estimated time of arrival

F9: Fine
FAQ: Frequently Asked Question(s)
FFS: For fuck sake
FMCDH: From My Cold Dead Hands
FML: Fuck my life
FOAD: Fuck off and die
FOAF: Friend of a friend
FTFY: Fixed that for you
FTL: For the loss
FTW: For the win
FTW?: Fuck the what?
FU: Fuck you
FUBAR: Fucked up beyond all recognition
FUD: Fear, Uncertainty and Doubt
FWIW: For what it is worth
FYI: For your information



GBTW: Get back to work
GF: Great fight
GFU: Good for you
GFY: Go fuck yourself
GG: Good game
GGS: Good games
GJ: Good job
GL: Good luck
GMTA: Great minds think alike
gratz: Congratulations
GTFO: Get the fuck out
GTG: Got to go
G2G: Got to go
GR: Good Race

HAND: have a nice day
HF: Have fun
haxor: Hacker
H4x0r: hacker
HTH: Hope this / that helps

IANAL: I am not a lawyer
IBTL: In before the lock
IDK: I do not know
IHT: I had to
IONO: I do not know
IIRC: If I recall / remember correctly
IIUC: If I understand correctly
ILY: I love you
IMO: In my opinion
IMHO: In my humble / honest opinion
IMNSHO: In my not so humble opinion
IMAO: In my arrogant opinion
IOW: In other words
IRC: Internet Relay Chat
IRL: In real life
ITYM: I Think You Mean
IWSN: I want sex now
IYKWIM: If you know what I mean
IZI: Easy


jaggy: aliased computer graphics
JAS: Just a sec
JFTR: Just for the record
JK: Just kidding
j/k: Just kidding


k: OK
kk: OK
KISS: Keep it simple stupid.
KOS: Kill on sight
KTHX: OK, thanks
kthxbye: OK, thanks, goodbye

L8R: Later
leet: elite
LFG: Looking for group
LFM: Looking for more
LMAO: Laughing my ass off
LMFAO: Laughing my fucking ass off
LMIRL: Lets meet in real life.
LMK: Let me know
LOL: Laughing out loud
LTNS: Long time no see
lulz: Laughing out loud
LYLAB: Love you like a brother
LYLAS: Love you like a sister


MFW: My face when
MMO: Massive Multi-player Online game
MMORPG: Massive Multi-player Online Role-Playing Game
MOTD: Message of the day
MTFBWY: May The Force be with you
MUD: Multi-User Dungeon
MUSH: Multi-User Shared Hallucination
MYOB: Mind your own business
M8: Mate


N1: Nice one
NE1: Anyone
NGL: Not gonna lie
NIFOC: Naked In Front Of Computer
NM: Not much
N/M: Not much
n0rp: porn
NP: No problem
NS: Nice shot
NSOH: No sense of humor
NSFW: Not safe for work
NVM: Nevermind
NVMD: Nevermind


O RLY: Oh really?
OIC: Oh, I see
OFN: Old freaking news
OMG: Oh my god
OMFG: Oh my fucking god
OMGWTF: Oh my God what the fuck
OMW: On my way or Oh my word
ONOZ: Oh, no
OP: Original poster / Operator / Outpost
OS: Operating system
OT: Off topic
OTB: Off to bed
OTOH: On the other hand
OTP: On the phone / One true pairing / On The Piss


P2P: Peer to peer / pay to play
PAW: Parents are watching
PEBKAC: Problem exists between keyboard and chair
PEBCAK: Problem exists between keyboard and chair
PITA: Pain in the arse / ass
PLMK: Please let me know
PMSL: Pissing myself laughing
POS: Piece of shit, or parent over shoulder.
POTS: Plain old telephone service
POV: Point of view
PL: Powerleveling
PPL: People
PTKFGS: Punch the Keys For Gods Sake
pr0n: porn
PW: Persistent World
pwned: owned
pix: pictures


QWP:  Quit Whining, Please


rehi: Hello again
RL: Real Life
RMS: Ride me sideways
ROFL: Rolling on the floor laughing
ROTFL: Rolling on the floor laughing
ROFLMAO: Rolling on (the) floor laughing my ass off
ROTFLMAO: Rolling on (the) floor laughing my ass off
ROFLMAOWPIMP: Rolling on (the) floor laughing my ass off while peeing in my pants
ROTFLMAOWPIMP: Rolling on (the) floor laughing my ass off while peeing in my pants
ROFLOL: Rolling on (the) floor laughing out loud
ROTFLOL: Rolling on (the) floor laughing out loud
RSN: Real soon now
RTFB: Read the fucking binary
RTFS: Read the fucking source
RTFM: Read the (fucking/fine) manual
RTM: reboot the (fucking) machine


SCNR: Sorry, could not resist
SFW: Safe for Work
sk8: skate/skater
sk8r: skate/skater
sk8er: skate/skater
SMH: Shaking my head
SNAFU: Situation normal: all (fucked/fouled) up
SOHF: Sense of humor failure
SOS: Someone (watching) Over Shoulder
STFU: Shut the fuck up
STFW: Search the fucking web


TANSTAAFL: There aint no such thing as a free lunch
TBF: Time between failures
TBH: To be honest
TG: That is great
TGIF: Thank God it is Friday
THX: Thanks
THNX: Thanks
TNX: Thanks
TX: Thanks
TIA: Thanks in advance
TIL: Today I learned
TIMWTK: This inquiring mind wants to know
TINC: There Is No Cabal
TINS: There is no spoon
TL DR: Too Long Did not Read
TL;DR: Too Long; Did not Read
TMI: Too much information
TOS: Terms of service
TTBOMK: To the best of my knowledge
TTFN: Ta ta for now
TTYL: Talk to you later
TTUL: Talk to you later
T2UL: Talk to you later
T2YL: Talk to you later
TTYN: Talk to you never
TTYS: Talk to you soon
TY: Thank you
TYT: Take your time
TYVM: Thank you very much


U: You
U R: you are
UTFSE: Use the fucking search engine
UGO: You got Owned
URS: You Really Suck

w00t : We Own the Other Team
W/: With
W/O: without
WB: Welcome back
W/E: Whatever
W/E: Weekend
WRT: With respect / regard to
WTB: Want to buy
WTF: What the fuck
WTG: Way to go
WTH: What the hell
WTS: Want to sell
WTT: Want to trade
WUG: What you got?
WUBU2: What (have) you been up to?
WUU2: What (are) you up to?
WYSIWYG: What you see is what you get
W8: Wait

YAGNI: You Aint Gonna Need It
YAGTOH: you are going to own him
YGM: You have Got Mail
YHBT: You have been trolled
YEC: Young Earth Creationism
YKW: You know what?
YMMV: Your mileage may vary
YOYO: You are On Your Own
YTMND: You are The Man Now, Dog
YW: You are welcome

ZOMG: Oh My God
